Acre	AC
Alagoas	AL
AmapÃ¡	AP
Amazonas	AM
Bahia	BA
CearÃ¡	CE
Distrito Federal	DF
EspÃ­rito Santo	ES
GoiÃ¡s	GO
MaranhÃ£o	MA
Mato Grosso	MT
Mato Grosso do Sul	MS
Minas Gerais	MG
ParÃ¡	PA
ParaÃ­ba	PB
ParanÃ¡	PR
Pernambuco	PE
PiauÃ­	PI
Rio de Janeiro	RJ
Rio Grande do Norte	RN
Rio Grande do Sul	RS
RondÃ´nia	RO
Roraima	RR
Santa Catarina	SC
SÃ£o Paulo	SP
Sergipe	SE
Tocantins	TO
